11,10,10,10,10,11,11,11,11,11,11,11,28,28,28,28
11,11,10,10,10,10,11,11,11,11,11,11,11,11,11,28
11,11,11,11,10,10,10,11,11,11,10,10,10,11,11,28
11,11,11,11,11,10,10,10,11,10,10,10,10,10,12,12
10,10,11,11,11,10,10,10,10,10,10,10,10,10,13,12
10,10,10,10,10,10,10,10,10,10,10,10,10,10,12,13
10,10,10,10,10,10,10,10,10,10,10,10,10,10,12,12
11,11,11,11,10,10,10,11,11,11,10,10,10,10,10,10
11,11,11,11,11,11,11,11,11,11,11,11,11,10,10,10
28,28,28,28,11,11,11,11,11,11,11,11,11,11,11,10
28,28,28,28,28,28,28,11,11,11,11,11,11,11,28,11
28,28,28,28,28,28,28,28,28,28,28,11,28,28,28,11
